
VespaBattery	KEYWORD1

handler_critical	KEYWORD2

getCalibrationType	KEYWORD2
getReferenceVoltage	KEYWORD2
readCapacity	KEYWORD2
readVoltage	KEYWORD2
setBatteryType	KEYWORD2

BatteryType	KEYWORD1

BATTERY_UNDEFINED	LITERAL1
BATTERY_LIPO	LITERAL1


VespaMotors	KEYWORD1

backward	KEYWORD2
forward	KEYWORD2
setSpeedLeft	KEYWORD2
setSpeedRight	KEYWORD2
stop	KEYWORD2
turn	KEYWORD2

FORWARD	LITERAL1
BACKWARD	LITERAL1


VespaServo	KEYWORD1

attach	KEYWORD2
attached	KEYWORD2
detach	KEYWORD2
getChannel	KEYWORD2
write	KEYWORD2

VESPA_SERVO_S1	LITERAL1
VESPA_SERVO_S2	LITERAL1
VESPA_SERVO_S3	LITERAL1
VESPA_SERVO_S4	LITERAL1

